showLabels=Show Labels
horizontalHierarchical=Horizontal Hierarchical
arrow=Arrow
defaultStyle=Default Style
image=Image
value=Value
pageSetup=Page Setup
format=Format
selectTree=Select Tree
targetSpacing=target spacing
vertical=Vertical
fillcolor=Fillcolor
help=Help
linestart=Linestart
actualSize=Actual Size
collapse=Collapse
style=Style
loseChanges=Lose Changes?
custom=Custom
global=Global
backgroundColor=Background Color
direction=Direction
ungroup=Ungroup
shadow=Shadow
dropEnabled=Drop Enabled
gridColor=Grid Color
none=None
linecolor=Linecolor
connector=Connector
verticalPartition=Vertical Partition
edit=Edit
verticalHierarchical=Vertical Hierarchical
horizontalPartition=Horizontal Partition
connections=Connections
handleReturn=Handle Return
basicStyle=Basic Style
allowLoops=Allow Loops
horizontal=Horizontal
removeFromGroup=Remove from group
label=Label
moveVertexLabels=Move Vertex Labels
zoomOut=Zoom Out
toBack=To Back
noSourceAndTargetSelected=No source and target selected.
toFront=To Front
middle=Middle
paste=Paste
labels=Labels
selectDirectedTree=Select Directed Tree
alignment=Alignment
backgroundImage=Background Image
connectable=Connectable
enterGroup=Enter group
page=Page
opacity=Opacity
preferPageSize=Prefer Pagesize
entityRelation=Entity Relation
gradient=Gradient
validation=Validation
size=Size
center=Center
north=North
imagePreview=Image Preview
tolerance=Tolerance
stylesheet=Stylesheet
noCellSelected=No cell selected.
warning=Warning
group=Group
shape=Shape
circleLayout=Circle
south=South
background=Background
selectEdges=Select Edges
layout=Layout
verticalTree=Vertical Tree
diamond=Diamond
left=Left
images=Images
labelFill=Label Fill
htmlLabels=HTML Labels
centerPage=Center Page
right=Right
cloneInvalidEdges=Clone Invalid Edges
print=Print
createTarget=Create Target
sourceSpacing=Source spacing
moveEdgeLabels=Move Edge Labels
autosize=Autosize
rotateLabel=Rotate Label
overwriteExistingFile=Overwrite existing file?
symbols=Symbols
new=New
zoomIn=Zoom In
display=Display
parallelEdges=Parallel Edges
grid=Grid
selectAll=Select All
antialias=Antialias
selectNone=Select None
rounded=Rounded
copy=Copy
open=Open
transparentBackground=Transparent Background?
updateGroupBounds=Update group bounds
selectPath=Select Path
pageLayout=Page Layout
openFile=Open File
position=Position
delete=Delete
pageBackground=Page background
diagram=Diagram
width=Width
straight=Straight
view=View
selectVertices=Select Vertices
scale=Scale
gridSize=Grid Size
file=File
aboutGraphEditor=About mxGraph Editor
plain=Plain
zoom=Zoom
top=Top
buffering=Buffering
cross=Cross
noImageData=No Image Data
options=Options
window=Window
spacing=Spacing
outline=Outline
dragAndDrop=Drag and Drop
hide=Hide
save=Save
enterWarningMessage=Enter warning message
noLayout=Layout unavailable
connectableEdges=Connectable Edges
west=West
bottom=Bottom
allowDanglingEdges=Allow Dangling Edges
rotation=Rotation
line=Line
dot=Dot
dirty=Dirty
centerZoom=Center Zoom
multigraph=Multigraph
cut=Cut
selectDirectedPath=Select Directed Path
pageBreaks=Page Breaks
shapes=Shapes
magnifyPage=Magnify Page
rulers=Rulers
oval=Oval
zoomToSelection=Zoom to Selection
classic=Classic
allImages=All Images
lineend=Lineend
saveAs=Save As
horizontalTree=Horizontal Tree
fontcolor=Fontcolor
placeEdgeLabels=Edge Labels
east=East
redo=Redo
newDiagram=New Diagram
error=Error
expand=Expand
selection=Selection
linewidth=Linewidth
dragEnabled=Drag Enabled
labelBorder=Label Border
exitGroup=Exit group
disconnectOnMove=Disconnect on Move
home=Home
dashed=Dashed
ready=Ready.
organicLayout=Organic
perimeter=Perimeter
textOpacity=Text opacity
block=Block
undo=Undo
align=Align
connectMode=Connect Mode
horizontalStack=Horizontal Stack
exit=Exit
verticalStack=Vertical Stack
